chartio                   - Setup wizard and connection client for connecting MySQL/PostgreSQL databases to Chartio
sqlbean                   - A auto maping ORM for MYSQL and can bind with memcached
pymysql_utils             - Thin wrapper around pymysql. Provides Python iterator for queries. Abstracts away cursor.
MySQL-python              - Python interface to MySQL
lovely.testlayers         - mysql, postgres nginx, memcached cassandra test layers for use with zope.testrunner
cymysql                   - Python MySQL Driver using Cython
pyormish                  - A simple, ultra-lightweight ORM for MySQL, SQLite, and Postgres
mysqlrocket               - Simple CLI tool to create and delete easily MySQL databases.
tiddlywebplugins.mysql3   - MySQL-based store for tiddlyweb
brubeck-mysql             - Brubeck module for MySQL Querysets using Schematics
sqlkit                    - GUI to edit databases. Many backend supported (Postgres, Sqlite, MySql,...).
Based on python, GTK, sqlalchemy. It's split into a GUI and a very rich package to create
database interfaces
replmon                   - A simple MySQL replication monitor
testing.mysqld            - automatically setups a mysqld instance in a temporary directory, and destroys it after testing
mysql-connector-python    - MySQL driver written in Python
simplemysql               - An ultra simple wrapper for Python MySQLdb with very basic functionality
tomdb                     - A simple wrapper around MySQLdb and pymysql.
django-mysqlpool          - Django database backend for MySQL that provides pooling ala SQLAlchemy.
zest.recipe.mysql         - A Buildout recipe to setup a MySQL database.
oursql                    - MySQL bindings for python.
PyMySQL                   - Pure-Python MySQL Driver
djorm-ext-pool            - DB-API2 connection pool for Django (for postgresql, mysql and sqlite)
PySQLPool                 - Python MySQL Connection Pooling and MySQL Query management
django-cymysql            - Django database backend for cymysql
django-mysql-fix          - This project contains optimizations (hacks) for MySQL for Django ORM
django-actionkit-client   - A Django wrapper around Actionkit's MySQL client-db, REST API and XML-RPC API
umysql                    - Ultra fast MySQL driver for Python
mygrate                   - Facilitates the migration of data from MySQL or MariaDB with no downtime.
versioning                - Python version sorting tool and MySQL version manager
mysql_commando            - mysql_commando is a lightweight MySQL driver
simplestore               - A datastore layer built on top of MySQL in Python.
MySQLObject               - A Python class to convert a simple object in a MySQL connection driver.
SimpleDB                  - A wrapper around MySQLdb to make development of quick scripts easier
MysqlSimpleQueryBuilder   - Simple MySQL query builder and profiler
SqlHBase                  - MySQLDump to HBase, ETL scripts
PyDbLite                  - A pure-Python db engine + Pythonic interface to SQLite and MySQL
bottle-mysql              - MySQL integration for Bottle.
SQLAntaresia              - Cross platform MySQL management tools aimed at both developers and system administrators
umysqldb                  - MySQLdb compatible wrapper for ultramysql
s3mysqlbkp                - MySQL backups to Amazon S3
HTSQL-MYSQL               - A Database Query Language (MySQL backend)
pymysqlrpc                - a rpc framework implement mysql server protocol on top of gevent
Flask-MySQL               - Flask simple mysql client
SchemaObject              - Iterate over a MySQL database schema as a Python object.
jaraco.mysql              - MySQLDB-compatible MySQL wrapper by Jason R. Coombs
Products.ZMySQLDA         - MySQL Zope2 adapter.
sa_mysql_dt               - Alternative implementation of DateTime column for MySQL.
CURD.py                   - Tiny Python ORM for MySQL
kvlite                    - key-value database wrapper for SQL database (MySQL, SQLite)
mysql-replication         - Pure Python Implementation of MySQL replication protocolbuild on top of PyMYSQL.
spgen                     - spgen is Stored Procedure Generator for MySQL.
torndb                    - A lightweight wrapper around MySQLdb.  Originally part of the Tornado framework.
SchemaSync                - A MySQL Schema Synchronization Utility
skylark                   - A micro python orm for mysql and sqlite.
mysqlclient               - Python interface to MySQL
py-mysql2pgsql            - Tool for migrating/converting from mysql to postgresql.
PyMySQL3                  - Pure Python MySQL Driver
freezer                   - OpenStack Swift incremental backup and restore automation tool for file system, MongoDB, MySQL. LVM snapshot and encryption support
mydb                      - db wrapper for mysql
mysql-latin1-codec        - Python string codec for MySQL's latin1 encoding
sqlShort                  - A tiny wrapper for the Python modules MySQLdb and Sqlite
mysql_backup              - mysql backup and restore tool
mysqldbda                 - MySQL Database adapter
django-mysql-aesfield     - Django Model Field that supports AES encryption in MySQL
MySlow                    - Play with mysql slow log
mysqlfuncs                - C functions to aid in implementing the mysql wire protocol
dones                     - Track what keys are "done" using MySQL to implement a simple key-store.
getMysqlConnPara          - Mysql connection parameters defined in a text file, reads the parameter file and return the connection parameter's dict
django-mysql-fuzzycount   - Approximate query counts for MySQL and Django.
mtstat-mysql              - MySQL Plugins for mtstat
cns.recipe.zmysqlda       - Recipe for installing ZMySQLDA
SQLAlchemy-FullText-Search - Provide FullText for MYSQL & SQLAlchemy model
myprefetch                - MySQL Replication Prefetcher
django-mysql-manager      - django-mysql-manager is a Django based management interface for MySQL users and databases.
mysql-statsd              - Daemon that gathers statistics from MySQL and sends them to statsd.
mysql-autodoc             - Generate HTML documentation from a mysql database
MySQL-python-embedded     - Python interface to MySQL
mysql2csv                 - Convert some or all tables in a MySQL database into CSV files.
mysql-connector-repackaged - MySQL driver written in Python
maim                      - MySQL querying tools
mydumper                  - Simple MySQL dumper
pymysql_sa                - PyMySQL dialect for SQLAlchemy.
myremotedump              - Dumps a firewalled MySQL database via a ssh tunnel to the remote system
opengever.mysqlconfig     - configures the mysql as database engine
raisin.mysqldb            - UNKNOWN
django-mysqlndb-backend   - 
minpubsub                 - A minimal PubSub based distributed message queue model with multiple backend persistence modes - SQLite, MySQL, MongoDB.
free4my                   - a easy to use schema free DAL for mysql
neo_my2pg                 - Migration package from mysql to postgresql
django-oursql             - Django database backend for MySQL via oursql.
SQLCache                  - SQLCache is loosely similar to memcached but using MySQL.
sqlwitch                  - sqlwitch offers idiomatic SQL generation on top of MySQLdb.
lurker                    - a tiny wrapper for mysqldb
django-mysql-pymysql      - Django MySQL backend for PyMySQL adapter
collective.recipe.zmysqlda - Recipe for installing ZMySQLDA
mysql-ct                  - 
RESTGuardian              - RESTful MySQL
mysql-utilities           - MySQL Utilities 1.4.3 (part of MySQL Workbench Distribution 6.0.0)
django-mysql-pool         - Django application.
mysqlqueryresult2dict     - Create dict from MySQL query result text.
raingutter                - A diff/sync tool for MySQL databases, including Drupal.
dbadmin                   - A python wrapper to do some basic dbadmin options with mysql
antbkp                    - Ant Backup. Simple Backup: Files, Rotation backups, Postgres, Mysql, OpenERP, Tryton,...
pg_chameleon              - Migration script from mysql to postgresql
siqueries                 - Setup wizard and connection client for connecting MySQL/PostgreSQL databases to siqueries.com
mysql-pyrex               - Pyrex interface to the MySQL 5 API.
msrestore                 - Backup sync aid for mysql-zrm and more.
mqueue                    - Simple queue based on mysql.
upsert                    - Upsert for MySQL, PostgreSQL, SQLite3.
